################################
#                              #
#                              #
#                              #
#                              #
#                              #
#                              #
#                              #
#           s          e       #
#                              #
#                              #
#                              #
#                              #
#                              #
#                              #
################################